1111111111111111111111111111111111
1000000100000000010000100001000001
1000000000000001010000000011000011
1000000000000001001010000000000001
1000010100001100000000100010010001
1000000001000000000000000000000001
1010000100000000000000000000100011
1000000000000000000000000000100001
10100000P0000000000010000000000001
1010100000000001000010000010000111
1000000000010001000010100010000001
1000000000000000000000000000000101
1000100100010101000000000000010001
10000000000000000000C0E00001000001
1000000000000000000000000000000101
1111111111111111111111111111111111