111111111111111111111111111111111111111111111111111111111111111
1P0000000000000000E11100000000000000000110100000000000000000011
100000111110000000001100000111110000000001100000111110000000001
100000000010000000001100000000010000000001100000000010000000001
100000000011001110001100000000011001110001100000000011001110001
100001111100000000001100001111100000000001100001111100000000001
10000000000000000C001100000000000000000001100000000000000000001
111110000011100000001111110000011100000001111110000011100000001
100011100000000000001100011100000000000001100011100000000000001
100000011111110000001100000011111110000001100000011111110000001
100000000000000000001100000000000000000001100000000000000000001
100000000000001111111100000000000001111111100000000000001111111
111110000000001C00001111110000000001000001111110000000001000001
1C0000000011111000001100000000011111000001100000000011111000001
100000111000000000001100000111000000000001100000111000000000001
100000000000011111101100000000000011111101100000000000011111101
100011100000000000001100011100000000000001100011100000000000001
100000000000000000C01100000000000000000001100000000000000000001
1000000000C0000000001100000000000000000001100000000000000000001
111111111111111111111111111111111111111111111111111111111111111