1111111111111111111111111
1111000X00100000100000111
1111000P000X0001100001111
1111000000000C0000X000111
1111000010100001001000111
11110000000010X00000E0111
1111111111111111111111111