111111111111111111111
1C00000X0000X00000E11
100C00000000000000001
1000X0C0010000X00CC01
1000C00001100101100P1
111111111111111111111